*** Day 1 ***

*** BBC 6 Minute Vocabulary. Academic vocabulary. ***
*** BBC 6 Minute Vocabulary. Commonly misspelled words. ***
*** BBC 6 Minute Vocabulary. Discourse Markers: Interjections. ***

misspelled -> неправильно написанное
meal -> еда, блюдо
acknowledge -> признавать, подтверждать
quarell -> ссора
interjections -> взаимодействие
relief -> облегчение
excitement -> волнение, возбуждение
admiration -> восхищение, восторг

*** Breaking bad ***
*** S1:E1 ***

dicking you around -> обмануть тебя
heater -> обогреватель
echinacea -> цветок эхинацея
crap -> дрянь, остой
band-aids -> лейкопластырь
matter -> вещество, материя
bond -> связь
fascinating -> увлекательно
flat as washboard -> плоский, как стиральная доска
hire -> нанимать
charming -> очаровательный
exhibition -> демонстрация, выставка
favor -> услуга, польза
lung -> лёгкое
whiff -> дуновение, слабый запах
suspect -> подозреваемый
custody -> стража
cheer up -> взбодрись, развеселись
not a clue -> ни малейшего понятия
flunk -> провалиться, пропустить
fumes -> пары, испарения
negotiate -> вести переговоры
waist -> талия, пояс
shrunk -> сужают
inch -> дюйм
willing -> желающий
batch -> партия

I love what I do.
I love my job.
I feel lucky to do what I do every day.